1yyyyyyyyyyyyyyyyyyyyyyyyyyyyyyyyyy1
1................R.................1
1..................................11111111111111111111111111111
1..............................................................1
1..............................................................1
1..............................................................1
1..............................................................1
1..............................................................1
000000000000000000000000000000000000...........................1
000000000000000000000000000000000000...........................1
000000000000000000000000000000000000...........................1
000000000000000000000000000000000000...........................1
000000000000000000000000000000000000...........................1
000000000000000000000000000000000000...........................1
000000000000000000000000000000000000...........................1
000000000000000000000000000000000000...........................1
000000000000000000000000000000000000...........................1
000000000000000000000000000000000000...........................1
000000000000000000000000000000000000...........................1
000000000000000000000000000000000000...........................1
000000000000000000000000000000000000...........................1
000000000000000000000000000000000000...........................1
000000000000000000000000000000000000...........................1
1..............................................................1
1..............................................................1
1..............................................................1
1..............................................................1
1..............................................................1
1..............................................................1
1..............................................................1
1................P.................11111111111111111111111111111
1xxxxxxxxxxxxxxxxxxxxxxxxxxxxxxxxxx1